8 8
WWWWWWWWWWWWWWWWW
W_ _ _ _ _ _ _ _W
W               W
W_ _ _ _ _ _ _ _W
W               W
W_ _ _ _ _ _ _ _W
W               W
W_ _ _ _ _ _ _ _W
W               W
W_ _ _ _ _ _ _ _W
W               W
W_ _ _ _ _ _ _ _W
W               W
W_ _ _ _ _ _ _ _W
W               W
W_ _ _ _ _ _ E _W
WWWWWWWWWWWWWWWWW
