8 8
WWWWWWWWWWWWWWWWW
W_ _ _ _ _ _ T _W
WW W            W
W_ _ _W_ _ 1 _ _W
W      W     W  W
W_ 4W_ _W_ _ _W_W
W               W
W_ _ _ _W_W_W_ _W
W              WW
W_W_W_ _ _W_ _W3W
W  W W          W
W_ _ _W_ _W_ _W_W
WW       W      W
W_ _ _W_W_ _ _ _W
W    W          W
W_ _ _ _W_ _W_ EW
WWWWWWWWWWWWWWWWW
