8 8
WWWWWWWWWWWWWWWWW
WK _ _ _W_ _ _ _W
WW         W    W
W_ _ _ _ _ _ _ _W
W      W     W  W
W_ _ _ _W_ _ _ _W
W      W   G    W
W_ _ _W_W_W_W_ _W
WW       W      W
W_ _ _ _ _ _ 0 _W
WW   W       W WW
W_W_ 4 _ _ _ _ _W
W  W   W W W    W
W_ _W_ _W_ _ _ 2W
W        W W    W
W_ _ _ _ _ _W_WEW
WWWWWWWWWWWWWWWWW
