8 8
WWWWWWWWWWWWWWWWW
W_W3 3 _W_ _ _ _W
W               W
W_ _ _W_ _W_ _ _W
WW       W W    W
W_ _W_ _ _ _W_ TW
W  W W W   W    W
W_W_ _ _W_W_ _W_W
WW           W  W
W_ _ _W_W_W_ _ _W
W      W     W  W
W_W_W_ _W_W_ _ _W
W  W W     W    W
W_ _W_ _ _ _W_WEW
W  W   W        W
W4 _ _W_ _ _W_ _W
WWWWWWWWWWWWWWWWW
