8 8
WWWWWWWWWWWWWWWWW
WE _ _ _ _ _ 2 _W
W    W     W   WW
W_ _ 4 _ _ _ _ _W
W  W W     W W  W
W_ _ _W_ _ _ K _W
W        W W G  W
W_W_ _W_ _ _ _W_W
W              WW
W_ _ _ TW_ _W_ _W
W      W W      W
W_ _ _W_ _ _ _ _W
WW   W W     W WW
W_ _ _ _ _ _ _W_W
W    W   W   W  W
W_W_ _ _ _ _ _ _W
WWWWWWWWWWWWWWWWW
