8 8
WWWWWWWWWWWWWWWWW
W_ _W_ _ _ _ _ _W
W      W        W
W_W_ _ _W_ _ _ _W
W    W          W
WEW_ _W_ _ 4 _W_W
W      G W      W
W_ _W_ _ _ 2 _ _W
W      W W      W
WTW_ _W_ 1 _ _ _W
W    W     W W  W
W_ _ _ _ _ 2 _ _W
W        W      W
W_ _WK _W_W_ _ _W
W      W   W    W
W_ _ _ _ _ _ _ _W
WWWWWWWWWWWWWWWWW
