8 8
WWWWWWWWWWWWWWWWW
W_W_ _W_ _ _ _ _W
W            W  W
W_ _ _ _ _W_W_ _W
W          W    W
W_W_ _ _ _W_ K _W
W               W
W_W_ _ _W_W_ _ 2W
W               W
W_ _ _W_ _W_ _W_W
WW         G    W
W_ _ _W4 _W_ _ 2W
W    W          W
W_ _W_W_ _ _W_ _W
WW W            W
W_ _ _ _ _ E _ _W
WWWWWWWWWWWWWWWWW
