6 6
WWWWWWWWWWWWW
W_ _ _ _ _ 2W
WW   W      W
W_ _ _ _W_ _W
W      W W  W
W_ _ _ _ _W_W
W  W   W W  W
W_ _ _ _ _WEW
W    W W    W
W_W_ _W_W_ TW
W    W      W
W_ _ _ _ _ 4W
WWWWWWWWWWWWW
